{
    "name":"breezy",
    "nodes":[
        {"x": 150, "y": -30},
        {"x": 130, "y": 60},
        {"x": 150, "y": 120},
        {"x": 500, "y": 160},
        {"x": 750, "y": 120},
        {"x": 600, "y": 190},
        {"x": 450, "y": 240},
        {"x": 150, "y": 240},
        {"x": 300, "y": 375},
        {"x": 750, "y": 450},
        {"x": 750, "y": 630}
    ],
    "waves":[
        {},
        {}
    ],
    "drawData":"tbd"
}